  ###############################################################################################
  #       #     #           #   #     #       # #             #         #             #     #   #
# ##### # ### # # ##### ### # # ### # ##### # # # # ######### ##### ### # ##### ####### ### # # #
# #     #     # #   #   # #   # #   #       #   # # #       # #   #   #   #     #     # # #   # #
# # ########### ### # ### ##### # ############### # # ##### # # # ####### # ##### ### # # ##### #
#   #   #       #   #   #       #       #     #   #   # #   #   #       # #         # #       # #
####### # ############# # ####### ##### # ### # ####### # ############# ########### # ### ##### #
#       # #         #   # #   #   #   #   #   #       # # #       #   #   #   #   # #     #   # #
# ##### # # ####### # ### # ### ### # ##### ######### # # ### ### ### ### # # # # # ####### # # #
# #     # #   #   # # # # #   #     #     #             #   # # #     # # # #   # #     #   #   #
# ####### # # # # # # # # # # ########### ################# # # ##### # # # ##### ##### # ##### #
#       # # # # # #   #   # #       #   # #       #   #     # #         # #   #   #   # #     # #
# ##### # # # ### ##### ########### # # # ##### ### # # ##### ######### # ### # ### ### ##### ###
#     #   # #   #     # #         #   #       #   # # # #   #       #   #     # #       #   #   #
##### ######### # ### # # ####### # ######### ### # # # # # # ##### # ######### ##### ### # ### #
#   # #     #   #   # #   #   #   #     #   #     # #   # # #   # # #         #     # #   # #   #
### # # ### # ##### ######### # ######### # # ##### ##### ##### # # # ############# # # ### # # #
#   # # # #   #   #           #           # # #     # #     #     # # #             # # #     # #
# # # # # ##### # ####### ### ############# # # ##### # ### # ##### # # ############### #########
# # #   #       # #       # # #     #   #   # # #       # #   # #   # # #   #         #     #   #
# ####### # ##### # ####### # ### # # # # ### # # ##### # ##### # ### # ### # ##### # ##### # # #
# #       #     #   #   # #       # # # #   # # # #   #   #     #   # #   # # #     # #   #   # #
# # ########### ### # # # # ####### # # ### ### ### # ### ### # ### ##### # # # ##### # # ##### #
# # #         # #   # # #     #   #   #   #   # #   #   #     #   # #     #   #     # # #       #
# # # # ####### ##### # ##### # # ##### ##### # # ##### ########### # ##### ####### # # ####### #
# # # #       # #     #     # # #   #   #     #       #     #     # # #   # #     # # #   # #   #
# # ######### # # ######### ### ### ##### ################# # ### # # # # # # ### # # ### # # ###
#   #       # # # #   #   # #   # #     #           #     #   #   #   # # # # # # # #     # #   #
# ### ##### # # # # # # # # # ### ##### ########### # ### ##### ### ### # ### # # # ####### ### #
#     #       #     #   # #           #               #         #       #     #     #            
###############################################################################################  