  #######################################################
    #           #       #       #     #           #     #
### # ######### # ##### ### ### ### # ### ####### # ### #
# # #     #   #   #   #   # # #   # #     #     # #   # #
# # ##### # ####### # ### # # ### # ####### ### # # ### #
# #       #   #     #   #   #   #   #   #   # #   # #   #
# ######### # # # ########### ####### ### ### ####### # #
#         # #   #   #     #         #   # #         # # #
# ####### # ####### # ### # ####### # # # # ####### # ###
#   #     # #     #   # #   #     #   #   #       # #   #
### # ### # # ### ##### ####### ################# # ### #
#   #   # # #   #     #       #               #   #   # #
# ##### # # ### # ##### # ### ######### ##### # ##### # #
#   #   # # #   #       # #     #     # #     #   #   # #
##### ##### ##### ####### ##### # ### # ### ##### # ### #
#   #     #     # #     #     #   #   #   # #     #     #
# # ##### ##### ### ### ##### ##### ##### # ### #########
# #       #   #   # # # #   # # #   #     #   #         #
# ####### # # ### # # # # # # # # ### ####### ##### ### #
#   #   # # # #   # # #   #   #   # #   #   # #   # #   #
# # # ### ### # ### # ######### ### # # ### # # # ### # #
# # #         #     #   #     #   #   #   # #   #     # #
# # ################# # # ### ### ####### # ########### #
# #   #   #           #     #   # #   #   #   #       # #
##### # # # ########### ####### # # # # ### # # # ##### #
#     # #   #     #   # #       # # #   # # # # #   #   #
# ### # ##### ##### # ### ####### # ##### # # # ### # ###
#   # # # #   #     #     #       # #   #   #   #   #   #
# # ### # # # # ######### # ####### # # ######### ##### #
# #     #   # #   #       # #     #   #         #     # #
# ########### ### ##### ### ### # # ########### ##### # #
# #         #   #     #   #   # # #   #       #   #   # #
# # ##### # # # ##### ####### # # ##### ##### ### # # # #
# # #     # # #   # # #     #   # #     #   #     # # # #
# # # ##### ### # # # # ### ##### # ##### # ####### ### #
# # # # #   #   #   #   # #     #   #     #       #     #
# ### # # ### ##### ##### ### ####### ####### ##### #####
#     #       #             #               #            
#######################################################  