  ###############
  #   #         #
# # # ### ### ###
#   #   #   #   #
####### ##### # #
# #   #     # # #
# # # ##### # # #
# # #   #   # # #
# # ### # ### # #
# # # # # #   # #
# # # # # ### # #
#     # #   # # #
# ##### ### # # #
#   #     # # # #
# ### ### # ### #
# #   #   #     #
# # ### ####### #
# # #       #   #
# # ####### # ###
# #   #     # # #
# ### ### ### # #
#   #   #   # # #
### ### ### # # #
#   # # #   #   #
# ### # ### ### #
#     #   #   # #
##### ### # ### #
#   #   # # #   #
# ##### # ### ###
#   #   #   #   #
# # # ##### ### #
# # # #   #   # #
# # # ### ### # #
# #   #     #   #
# ##### ### #####
#       # #     #
######### ##### #
#             # #
####### ##### # #
#       #   # # #
# ####### ### # #
#   #   #     # #
# # # # # ##### #
# # # #   #   # #
### # ##### # # #
#   # #   # #   #
# ### # # # #####
#   #   # #     #
### ########### #
#   #         # #
# # # ### ##### #
# # # # # #   # #
# ### # # # # # #
# #   # #   #   #
# # ### #########
#   #         # #
# ### ####### # #
#     #   # # # #
####### # # # # #
#       #   # # #
####### ### # # #
#       #   #   #
# ####### ##### #
# #     # #   # #
# ##### # ### # #
# #   #       # #
# # # ######### #
#   #           #
###############  
###############  