  ###########################################################################
              #         #     #     #       #       #                   #   #
############# # ##### # # ### # ### # ### # ### # ### ############### # # ###
#     #     # #     # # #   # #   #   #   # #   # #   #         # #   # #   #
# # ### ### # ### ### # # # # ##### ### ### # ### # ### ####### # # ### ### #
# #     # # #   # #   # # # #     # # # #   #   # #     #     #   # # #     #
# ####### # ### ### ### ### ##### # # # # ### # ######### # ### ### # # #####
#     #   #   #   # #       #   # #   # #   # #   #     # # #   #   #   #   #
##### # ##### ### # ######### # # ##### ### ##### # # ### # # ### ### ### # #
#   # # #     #   #     #     # # #   #   # #   #   #     # #   #   #   # # #
# ### # # ##### ### ### # ### # # # # # # # # # ######### # # ##### ##### # #
#   # # # #   # #     # #   # # #   # # # # # #         # #   #   #       # #
# # # # # # # # ####### # ### ####### ### # # ######### ####### # ####### # #
# #   # #   # #         # #   #     #   # #   #       #   #   # #   #   # # #
# ##### ##### ########### # ### ### ### # ##### # ####### # # # ### # # ### #
#           #             #       #       #     #           #   #     #     #
###########################################################################  
###########################################################################  