  ############################################################
    #       #         #               #   #     #       #   ##
### # ##### # ### ##### ### ######### ### # # ### ### # ### ##
# # #   #   # # #       # #   #     #   #   #       # #   # ##
# # ### # ### # ######### ### # # ##### ########### # ### # ##
# #   # #   # #     #       # # #     #         #   # #     ##
# ### # ##### # # ### ##### # # ### ########### # ### ########
#   # #       # #   #     # # #   #     # #     #   #       ##
### # # ########### # ##### # # ##### # # # ####### ####### ##
#   # #       #   #   #     # # #     #   # #     #       # ##
# # # ####### # # ##### ### # # # ######### ### # ##### ### ##
# # # #         # #     #   # # # #   #     #   # # #   #   ##
# # # # ######### # ### ##### # # # # # ##### ### # # ### # ##
# # # # #     #   # #   #     # #   # # #       # #     # # ##
# ### ### ### ### # ##### ##### ##### # ####### # ####### # ##
#   #     # #   #   #     #   # #   # #         # #       # ##
### ####### ### # ### ####### # # # # ########### # ####### ##
#     #       # # #   #     #   # #   #           # # #     ##
# ##### # ##### ### ### ### # ### # ### ########### # # ######
# #   # # #   #   #     #   # # # # #   #     #     # #     ##
# # # # # # # ### ####### ### # # ### ### ### ##### # ##### ##
#   #   #   #             #     #         #         #         
############################################################  