  ############################################################################
    #     #       #                   #       #       #         #     #     ##
### ### # ##### # ####### # ####### ### # ### ##### # ##### ### # ##### # ####
# #     # #     #       # #       # #   # # #       #       #   #     # #   ##
# ####### # ########### # ####### ### ### # # ############### ### ### # ### ##
#       # # # #       # #   #   #     # # #   #     # #     #   # # #     # ##
# ##### # # # # # ### # ### ### ####### # ##### ### # # # # ### # # ####### ##
#     # # # # # #   # # # # #       #   #     #   # #   # # #   #     #   # ##
# ### ### # # # ### ### # # # ##### # ####### # ### # ### # # ######### # # ##
# # # #   # # # # #     # # # #     #       # # #   # # # # #           # # ##
# # # # ### # # # ####### # # # ####### ##### # # ### # # ############### # ##
#   # #     #   #         #   # #       #     # # #     #               #   ##
### # ####### ### ############# ### ##### ### # # ####### ####### ##### ### ##
#   #     # # #   #                 #     # # # #       #   #   #     #   # ##
# ### ### # # # ### ####### ######### ##### # # ####### ##### # ### ##### # ##
# #   #     # #     #     #     #     # #     # #     #     # # #   #   # # ##
# # ######### ####### ### ##### # ##### # ##### # ### ##### # # ##### # # # ##
# #           #   #   # #     # #   #     #   # # #   #   #   #       # #   ##
# ############# # # ### ##### # ### ####### # # # # ##### ############# # ####
# #         #   # #   #       #   # #   #   # #   #     #         #     #   ##
# ####### # ### # ### # ######### # # # # ### ######### ### ##### # ####### ##
#         # #   #   # #   #       #   # # #   #       #     #   # # #   #   ##
########### # ##### # ### ##### ####### # # ### ### # # ##### # ### ### # ####
#     # #   # # #   # #   #   # #     #   #   #   # # # #     #     #   # # ##
# ### # # ### # # ### # ### # # # ### # ##### # ### # # # ########### ### # ##
# # # # # #   # # #   #     # # # #   #   # #   #   # # #         #       # ##
# # # # # # ### # ### ####### # # ### ### # ##### ##### ######### ### ##### ##
# #     #   #   #     # #     # #   #   #   #   #               #   # #     ##
# ##### ####### ####### # ##### ### ### ##### # # ############### # # # ### ##
# #   #   #             # #   #   #   #       # # #     #       # # # #   # ##
# # # ### # ##### ####### # # # ##### ######### # # ##### ##### ### # ### ####
#   # #     #     #       # # # #   # #     #   #   #     # #   #   #   #   ##
# ### ############# ####### # ### # # # # ### ####### ##### # ### ##### ### ##
#   #                       #     #   # #             #           #           
############################################################################  