  #####################################################################################
    #         #   #             #                             #                 #     #
### ####### # ### # ##### ##### ##### ####### ######### ####### # ############# # ### #
# #     #   #     #   # #     #     # #     #   #     # #       # #     #     # #   # #
# ##### # ### ####### # ##### ##### ### ### ### # ### ### ####### ### # # # # # # # # #
#     # #   # #     #       # #   #   # #     # # # #   # #     #   # # # # # # # # # #
### ### # # ### # ##### ##### # ##### # ##### # # # ### # # ### ### # # # # ### ### ###
#   #   # #   # #       #     # #     #   #   # #   # #   # # #     # # # #   #   #   #
# ### ### ### # ######### ##### # ##### # # ### ### # ##### # ####### # # ### ### ### #
#   # #     #       #   #   #     #   # # #   #           # #       # # #   #   # #   #
### # ############### # ### # ####### # # ### ############# # ### ### # ### ### # # # #
#   #           #     #     #       #   # # #               #   #   # #   # #   #   # #
# ############# # # ############### ### # # ################### ### # ### # # # ##### #
#       #     # # # #   #   #     #   # # #         #     #   #   # #   #   # #   #   #
##### # # ### # # ### # # # # # ##### ### # ##### ### # ### # ### # ### ##### ### # ###
#     # # #   # #     #   # # # #     #   #     # #   #     # #   #       #   #   # # #
# ##### # # ### ########### # # # ##### ### ##### # ######### # ########### ### ### # #
# #     # #   # #       #   # #   #     #   #   # # # #     #   #         # #   # # # #
# ####### ### # # ##### # ### ######### ##### # # # # # ### ### # ####### # # ### # # #
#   #     #   # #   #   # #   #   #     #     #   #   #   #   # #   #       #     #   #
# # # ##### ### # # ### # # ### # # ##### ### ####### ### ### # ### ############# ### #
# #   #   # #   # #   #   # #   #   #       # #         # #   # # #     #   #       # #
# ##### # # # ### ### ##### ### ########### ### ######### # ### # ##### # # ######### #
#   #   # # #   # # # #   #   # #         #       #   #   #   #   #   # # #   #     # #
### # ##### ### # # # # # ### # # # ##### ######### # # ##### ### # ### # ### # ### # #
# # #     #     #   # # #   #   # # #               #   #   # #   #   # # # #     # # #
# # ##### ########### # ### ####### ######### ########### ### # ### # # # # ####### # #
# # #   #       #     # # #       #         # #       #     # # #   # # # #   #     # #
# # # # # ##### # ##### # ####### # ####### # # ##### ##### # # ### # # # # # # # ### #
# #   #   #   #   #     #       # # #       # #     #     # # #   # # # # # # # # #   #
# ######### # ##### ##### ##### # ### ### ######### ##### # # ### # # # # # # # # # ###
#     #     #   #     #   #   #   #   #   #       # #     #   #   # # # # # # # # # # #
# ##### ####### # ### # ##### ##### ### ### ##### # # ##### ### ##### # # # # # ### # #
# #     #     # # # # #     #     # # # #   #   #   #   # #   # #     # # # # #   #   #
# # ##### ##### # # # ##### # ### # # # # ### # ####### # ### # # # ### # # ##### ### #
#   # #       # #   #   #   #   #   #   # #   #         # #   #   # #   # # #   #   # #
# ### # ##### # ### ### # ##### ##### ### # ############# # ####### # ### # # # ### # #
#   #     #   #     #   #     #   #   #   # #     #     # # #   # # #   # #   #   # # #
### # ##### ######### ####### ### # ### ### ### ### # # # # # # # # ### # ### # ### # #
# # # #   #         #       #     # #     #   #     # #   #   # # # #   #   # #   #   #
# # ### # ### ##### ####### ##### ### ####### # ##### ######### # # # # ### ##### #####
# #     #   # #   #   #     #     #   #       #     #       #   #   # #   #       #   #
# ######### # # ##### # ##### ##### ### ##### ##### ##### ### ####### ### ####### # # #
#         #   #     # #   #     # # # #     # #   # #   #     #     #   # #     # # # #
##### ########### ### ### ##### # # # ##### ### # ### # # ####### # # # ### ### # ### #
#     #         #   #   #   #     #     # #   # #     # #         # # #     #   # #   #
# ##### ##### # ### ### ### # ######### # ### # ####### ########### ######### # # # ###
#       #     #     #   # # #   #     # #   #   #   #   #         #   #       # # #   #
# ####### ########### ### # ##### # # # ### ##### ### ######### ##### # ##### ### # # #
#   #   #             #   #   #   # # # #     #     #         # #   # #     # #   # # #
### # # ############### # ### # ### ### # ##### ### ######### # # # # ##### ### ##### #
#   # # #     #   #     #   #   # # #   #         #         # #   #   #   #   #   #   #
# ### ### # # # # ### ########### # # ### ############# # ### ##### ### # # # ### # # #
# #       # #   #   #           # # # #   #     #       # #   #   # #   # # #   #   # #
# # ####### ####### ### ##### # # # # # ### ##### ####### # ### # # ### # # # ####### #
# #       #   #   #   # #   # #   # # #   # #     #     # #     # #   # # # # #       #
# ####### ### ### ### # ### # ##### # ### # # ####### # # ####### ### # # ### # #######
#   #       #   #     # #   #   #   # # #   #   #   # # # #     #   # # #     #       #
### # ######### # ##### # ##### # ### # ### ### # # # # # ##### ### # # ##### ####### #
#   #   # #     #   #   #     # #     #   # # #   # # # #     #   # #   #   #   # #   #
# ##### # # ####### ### ##### # ####### # # # ##### ### ##### ### # ##### # ### # # ###
# #       # #     #   #   #   #       # # # #     # #     #   #   #     # #       # # #
# ### ##### # ### ### ### # # ##### # # ### # ##### # ##### ### # ##### # ######### # #
#   # #     #   #   # #     # #     # #     #   #   # #     #   #   #   # #   #     # #
### ### ####### # ### ####### # ##### ##### ### # ### # ##### ##### # ### # # # ##### #
# #   # #   # # #   #   #     # #   #     #     #   #   # #   # #   # # # # # # #     #
# ### # # # # # ### ### ##### # ### ##### ##### ### ### # # # # # ### # # ### # ### # #
#   # #   # # # # #   #     # #   #     #   #     #   # #   # #     # # #     #   # # #
# # # ### # # # # ### ##### # ### # ### ### ######### # ##### # ##### # ##### ### # # #
# # #   # # # #     #     # #   # #   #               # #     #   #   #     #   #   # #
# # ### ### # ### ##### ### ### # ##################### # ####### # ####### # ####### #
# #     #   #     #   # #   #   # #       #   #       #   #   #   #   #   #   #     # #
# ####### ######### # # # ### ### # ##### # # # ##### ##### # # ##### # # # ### ### # #
# #     #     #     #   # #     #     #   # # # #   #       #   # #   # # # #   # # # #
# # # ### ### # ####### # # ######### # ### ### # # ############# # ### # ### ### # # #
# # #   # # # # #   #   # # # #     # # #       # #           #   #   # #   # #   #   #
# # ### # # # # # # ### # # # # ### ### # ############### ### # # ### # ### # ### #####
# #   #   # # # # #   # # #   # # # #   #   #     #   #   #   # #   #     # #     #   #
# ### ##### # # # ### ### ### # # # # ##### ### # # # # ### ### ### ####### ##### # # #
# # # #     # #   # #     #   # #   #   # #   # #   # #   #   # # # # #     #   # # # #
# # # ### # # # ### ####### ### # ##### # ### # ##### ### ### # # # # # ### # ### # # #
# #   #   # # # #       #   #   #       #   # #   #       #   # # #   #   # #   #   # #
# # ### # ### # ##### # ##### ########### ### # # ######### ### # # ##### # ### ##### #
# # #   # #   #       #       #     #   #     # #   # #     #   #   #     #   # #   # #
# # # # ### ##################### ### # # ##### ### # # ##### # ##### ####### # # # # #
# #   # #   #   #       #         #   # # # #   #   # #   #   #     #     #     # # # #
# ##### # ### # ### ##### # ####### ### # # # ### ### ### # ####### ##### # ##### # # #
#     # # #   #     #     # #   #   # # # #     # # #   # # #   #   #     #   #   # # #
##### ### # # ####### ##### # # # ### # # ####### # # # # ### # # # # ######### ### # #
#         # #             #   #       #           #   #       #   # #             #    
#####################################################################################  